     ########
  ####      #####
  #. $ ##      @#
  # ## ##*#     #
###     $ #     ##
#    .    #  #   #
# #       #      #
# #          #   #
#   ### ###     ##
### $           #
  #    .        #
  ######   ######
       #####