 ####
 #  ###
 #    #
##@$  #
#   .##
#    #
#  $ #
#   .#
######